-1 -1 -1 -1 -1 -1 -1 -1 13 -1 -1 -1 -1 -1 -1 
130 -1 -1 -1 -1 -1 -1 109 34 -1 -1 -1 -1 -1 -1 
63 63 63 63 63 63 63 63 63 85 -1 -1 -1 -1 -1 
-1 -1 -1 -1 -1 -1 -1 -1 -1 117 -1 -1 -1 -1 -1 
-1 -1 -1 117 -1 -1 -1 -1 -1 138 -1 -1 -1 -1 -1 
-1 -1 -1 138 -1 -1 -1 -1 -1 59 59 59 61 61 114 
-1 114 125 74 -1 -1 -1 -1 -1 -1 -1 113 -1 -1 135 
-1 135 125 -1 -1 -1 -1 13 -1 -1 136 32 -1 -1 135 
-1 135 125 -1 -1 -1 -1 34 -1 136 115 -1 -1 -1 135 
31 31 31 31 134 134 134 31 31 115 33 31 31 31 31 
